##################################################
#................................................#
#................................................#
#................................................#
#................................................#
#................................................#
#................................................#
#...................##########...................#
#................................................#
#................................................#
#................................................#
#................................................#
#................................................#
#................................................#
#...........########..........########...........#
#................................................#
#................................................#
#................................................#
#................................................#
#................................................#
#................................................#
#................................................#
#..########..........########..........########..#
#................................................#
#................................................#
#................................................#
#................................................#
#................................................#
#................................................#
#................................................#
#.......########..................########.......#
#................................................#
#................................................#
#................................................#
#................................................#
#................................................#
#....P......................................B....#
##################################################
